#########################
#                       #                                   
#                       #
#                       #                             
#                       #
#                       #
#                       #                       
#                       #
#                       #
#           $           #
#           @           #
#                       #
#                       #
#                       #
#                       #
#                       #                             
#                       #
#########################

